18:1,6:1,0:1,0:1,0:1,0:1,0:1,0:1,0:1,0:1,0:1,0:1,0:1,0:1,0:0,0:0,1:1,0:0,0:0,0:0,0:0,0:0,0:0,0:0,0:0,0:0,0:0,0:0,0:0,0:0,0:0,0:0,0:0,0:0,0:0,0:0,0:0,0:0,0:0,17:1
5:1,0:0,0:0,0:0,0:0,0:1,0:0,0:0,0:0,0:0,0:0,0:1,0:0,0:1,0:0,0:0,0:0,0:0,0:0,0:0,0:0,0:0,0:0,0:0,0:0,0:0,0:0,0:0,0:0,0:0,0:0,0:0,0:0,0:0,0:0,0:0,0:0,0:0,0:0,0:0
5:1,0:0,0:0,0:0,0:0,0:0,0:0,0:0,0:0,0:0,0:0,0:0,0:1,1:1,0:0,0:0,2:1,0:0,1:1,0:0,0:0,0:0,0:0,0:0,0:0,0:0,0:0,0:0,0:0,0:0,0:0,0:0,0:0,0:0,0:0,0:0,0:0,0:0,0:0,0:0
5:1,0:0,0:0,0:0,0:0,0:0,0:0,0:0,0:0,0:0,0:0,0:0,0:0,0:0,0:0,0:0,0:0,0:0,0:0,0:0,1:1,0:0,0:0,0:0,0:0,0:0,0:0,0:0,0:0,0:0,0:0,0:0,0:0,0:0,0:0,0:0,0:0,0:0,0:0,0:0
5:1,0:0,5:1,0:0,0:0,0:0,0:0,0:0,0:0,1:1,0:1,0:0,0:1,0:0,0:0,0:0,0:0,0:0,17:1,0:0,0:0,0:0,0:0,0:0,0:0,0:0,0:0,63:1,0:0,0:0,0:0,0:0,0:0,0:0,0:0,0:0,0:0,0:0,0:0,0:0
11:1,6:1,16:1,0:0,0:0,0:0,0:0,0:0,0:0,0:0,0:0,13:1,0:1,0:0,3:1,0:0,0:0,0:1,0:1,0:0,0:0,0:0,0:0,0:0,0:0,0:0,45:1,0:0,64:1,0:0,0:0,0:0,0:0,0:0,0:0,0:0,0:0,0:0,0:0,0:0
0:0,0:0,0:0,0:0,0:0,0:0,0:0,0:0,0:0,0:0,0:0,0:0,0:1,0:0,0:0,0:0,0:0,0:0,0:0,0:0,0:0,1:1,0:0,0:0,0:0,0:0,0:0,64:1,0:0,0:0,0:0,0:0,0:0,0:0,0:0,0:0,0:0,0:0,0:0,0:0
0:0,0:0,0:0,1:1,0:0,0:0,0:0,0:0,1:1,0:0,0:0,0:0,0:0,0:0,0:1,0:0,0:0,0:0,0:0,0:0,0:0,0:1,0:0,0:0,0:0,0:0,0:0,0:0,0:0,0:0,0:0,0:0,0:0,0:1,0:0,0:0,0:0,0:0,0:0,0:0
0:0,0:0,0:0,1:1,2:1,0:0,0:0,0:0,0:0,0:0,0:0,0:0,0:0,0:1,0:0,0:0,2:1,0:0,0:0,0:0,0:0,0:0,0:0,0:0,0:0,0:0,0:0,0:0,0:0,1:1,1:1,1:1,1:1,0:0,0:0,0:0,0:0,0:0,0:0,0:0
0:0,0:0,0:0,2:1,1:1,0:0,0:0,1:1,1:1,0:0,0:0,0:0,0:0,0:0,0:0,1:1,1:1,0:0,0:0,0:0,0:0,0:0,0:0,0:1,0:0,0:0,0:0,0:0,0:0,1:1,1:1,1:1,1:1,0:0,0:0,0:0,0:0,0:0,0:0,0:0
0:0,0:0,0:0,1:1,1:1,0:0,0:0,0:0,0:0,0:0,0:0,1:1,0:0,0:0,0:1,0:0,0:0,0:0,0:0,0:0,0:0,0:0,0:0,0:0,0:0,0:0,0:0,0:0,0:0,1:1,1:1,1:1,1:1,0:0,0:0,0:0,0:0,0:0,0:0,0:0
0:0,0:0,0:0,2:1,0:0,0:0,0:0,0:0,2:1,0:0,0:0,0:0,0:0,0:0,1:1,0:1,0:0,0:0,0:0,0:0,0:0,0:0,0:0,0:0,0:0,0:0,1:1,0:0,0:0,1:1,1:1,1:1,1:1,0:0,7:1,0:0,0:0,0:0,0:0,0:0
0:0,0:0,0:0,0:0,0:0,0:0,0:0,0:0,0:0,0:0,0:0,0:0,0:0,0:0,0:0,0:1,0:0,0:0,0:0,0:0,0:0,0:0,0:0,1:1,0:1,0:0,0:0,0:0,0:0,0:0,0:0,0:0,0:0,0:0,0:0,0:0,0:0,0:0,0:0,0:0
0:0,0:0,0:0,0:0,0:0,0:0,1:1,0:0,0:0,0:0,0:0,0:0,0:0,0:0,0:0,0:1,0:0,1:1,0:0,1:1,0:0,0:0,0:0,0:0,0:0,0:0,0:0,0:0,0:0,0:0,0:0,0:0,0:0,0:0,0:0,0:0,0:0,0:0,0:0,0:0
0:0,0:0,0:0,0:0,0:0,0:0,0:0,0:0,1:1,0:0,0:0,0:0,0:0,0:0,1:1,0:1,0:0,0:0,0:0,0:0,0:0,0:0,0:0,0:0,0:0,0:0,0:0,0:0,0:0,1:1,0:0,0:0,0:0,0:0,0:0,0:0,0:0,0:0,0:0,0:0
1:1,0:0,0:0,0:0,0:0,1:1,0:0,0:0,0:0,0:0,0:0,0:0,0:0,0:0,1:1,0:0,0:0,0:0,0:0,0:0,0:0,0:0,0:0,0:0,0:0,0:0,0:0,0:0,0:0,0:0,0:0,0:0,0:0,0:0,0:0,0:0,0:0,0:0,0:0,0:0
0:0,0:0,0:0,1:1,0:0,0:0,1:1,0:0,0:0,0:0,0:0,0:0,0:0,0:0,0:0,0:0,1:1,0:0,0:0,0:0,0:0,0:0,0:0,0:1,0:1,0:0,0:0,0:0,0:0,0:0,0:0,0:0,0:0,0:0,0:0,0:0,0:0,0:0,0:0,0:0
0:0,0:0,0:0,0:0,0:0,0:0,1:1,0:0,1:1,0:0,0:0,0:0,0:0,0:0,1:1,0:0,0:1,0:0,0:0,0:0,0:1,0:0,1:1,1:1,1:1,1:1,0:0,0:0,1:1,1:1,1:1,1:1,1:1,1:1,0:0,0:0,0:0,0:0,0:0,0:0
0:0,0:0,0:0,0:0,1:1,0:0,1:1,0:0,0:0,0:0,0:0,0:0,0:0,0:0,0:0,0:0,0:0,0:0,0:0,0:0,0:1,0:0,1:1,2:1,2:1,1:1,0:0,0:0,1:1,2:1,2:1,2:1,2:1,1:1,0:0,0:0,0:0,0:0,0:0,0:0
0:0,0:0,0:0,0:0,0:0,0:0,0:0,0:0,0:0,0:0,0:0,0:0,0:0,1:1,0:0,0:1,0:0,0:0,0:0,0:0,0:1,0:0,1:1,2:1,2:1,1:1,0:0,0:0,2:1,2:1,16:1,1:1,2:1,1:1,0:0,0:0,0:0,0:0,0:0,0:0
0:0,1:1,0:0,0:0,0:0,0:0,1:1,0:0,0:0,0:0,0:0,0:0,0:0,0:0,0:0,1:1,0:0,0:0,0:0,0:0,0:1,0:0,1:1,1:1,1:1,1:1,0:0,0:0,1:1,1:1,8:1,3:1,3:1,0:1,0:0,0:0,0:0,0:0,0:0,0:0
0:0,0:0,0:0,0:0,0:0,0:0,0:0,1:1,0:0,0:0,0:0,0:0,0:1,0:0,0:0,0:0,0:1,0:0,0:0,0:0,0:1,0:0,0:0,0:1,0:0,0:0,0:0,0:0,2:1,2:1,5:1,2:1,2:1,1:1,0:0,0:0,0:0,0:0,0:0,0:0
0:0,0:0,0:0,0:0,0:0,0:0,0:0,0:0,0:0,0:0,1:1,0:0,0:0,0:0,0:0,0:0,0:0,0:0,0:0,0:0,0:0,0:0,0:0,0:1,0:0,0:0,1:1,0:0,1:1,2:1,6:1,1:1,1:1,0:1,0:0,0:0,0:0,0:0,0:0,0:0
0:0,0:0,0:0,0:0,1:1,0:0,0:0,1:1,0:0,0:0,0:0,0:0,0:0,0:0,0:1,1:1,0:0,0:0,0:0,0:0,0:0,0:1,0:0,0:1,1:1,0:0,0:0,0:0,0:0,0:0,0:0,0:0,0:0,0:0,0:0,0:0,0:0,0:0,0:0,0:0
0:0,0:0,0:0,0:0,0:0,0:0,0:0,0:0,0:0,0:0,0:0,0:0,0:0,0:0,0:1,0:1,0:0,0:0,0:0,0:0,0:0,0:0,1:1,1:1,0:0,0:0,0:0,1:1,0:0,0:0,0:0,0:0,0:0,0:0,0:0,0:0,0:0,0:0,0:0,0:0
0:0,0:0,0:0,0:0,0:0,0:0,0:0,0:0,0:0,0:0,0:0,0:0,0:0,0:0,0:0,0:0,0:0,0:0,0:0,0:0,0:0,0:0,0:0,0:0,0:0,0:0,0:0,0:0,1:1,0:0,0:0,0:0,0:0,0:0,0:0,0:0,0:0,0:0,0:0,0:0
0:0,0:0,0:0,0:0,0:0,0:0,0:0,0:0,0:0,0:0,0:0,0:0,0:0,0:0,0:0,0:0,0:0,0:0,0:0,0:0,0:0,0:0,0:0,0:0,0:0,0:0,0:0,0:0,0:0,0:0,0:0,0:0,0:0,0:0,0:0,1:1,0:0,0:0,0:0,0:0
0:0,0:0,0:0,0:0,0:0,0:0,0:0,0:0,0:0,0:0,0:0,0:0,0:0,0:0,0:0,0:0,0:0,0:0,0:0,0:0,0:0,0:0,0:0,1:1,0:0,0:0,0:0,0:0,0:0,0:0,0:0,0:0,0:0,0:0,0:0,0:0,0:0,0:0,0:0,0:0
0:0,0:0,0:0,0:0,0:0,0:0,0:0,0:0,0:0,0:0,0:0,0:0,0:0,0:0,0:0,0:0,0:0,0:0,0:0,0:0,0:0,0:0,0:0,0:0,0:0,0:0,0:0,0:0,0:0,0:0,0:0,0:0,0:0,1:1,0:0,0:0,0:0,0:0,0:0,0:0
19:1,0:0,0:0,0:0,0:0,0:0,0:0,0:0,0:0,0:0,0:0,0:0,0:0,0:0,0:0,0:0,0:0,0:0,0:0,0:0,0:0,0:0,0:0,0:0,0:0,0:0,0:0,0:0,0:0,0:0,0:0,0:0,0:0,0:0,0:0,0:0,0:0,0:0,0:0,5:1
